R 3200 2000
NO ./path_to_the_north_texture
SO ./path_to_the_south_texture
WE ./path_to_the_west_texture
EA ./path_to_the_east_texture
S ./path_to_the_sprite_texture
F 33,33,34
C 4,15,42

1111111111   1111111111
1E00000001111100000000111111111
1000010000000000001110000000001
1110010000111111111000011110001
1000010011000000000011000111101
1000000000000000000000100000001
1111111111110000011111111111111
           1000001             
           1000001             
           1000001             
           1000001             
		   1111111
