R 192 1080
NO ./path_to_the_north_texture
SO ./path_to_the_south_texture
WE ./path_to_the_west_texture
EA ./path_to_the_east_texture
S ./path_to_the_sprite_texture
F 254,100,0
C 225,30,69

11111111
10000001
10111111
10000001
100S00011
10000001
1000100111111
1000100000001
1000100000001
10001111111111
10001
10001
10001
11111