R 3200 2000
NO ./path_to_the_north_texture
SO ./path_to_the_south_texture
WE ./path_to_the_west_texture
EA ./path_to_the_east_texture
S ./path_to_the_sprite_texture
F 254,100,0
C 225,30,69

1111111111111111
1000000000000001
1000000000000001
1000000000000001
100000N000000001
1000000000000001
1000000000000001
1111111111111111