R 3200 2000
NO ./path_to_the_north_texture
SO ./path_to_the_south_texture
WE ./path_to_the_west_texture
EA ./path_to_the_east_texture
S ./path_to_the_sprite_texture
F 25,25,25
C 100,100,100 

111111111111111111111111111111111       
100000000000000000000000000000001
100000000000000000000000000000001
111111100000000000000111111110001
10000000000000000000000E000000001
100000000000000000000000000000001
111110111100000111110000001111101
100000000000000000000000000000001
100000000000000010000000000000001
100000000000000000000000000000001
100000000000111111111000000000001
1000000000001       1000000000001
100000000000111111111000000000001
100000000000000000000000000000001
111111111111111111111111111111111  
