R 3200 2000
NO ./path_to_the_north_texture
SO ./path_to_the_south_texture
WE ./path_to_the_west_texture
EA ./path_to_the_east_texture
S ./path_to_the_sprite_texture
F 254,100,0
C 225,30,69

11111111
10000001
1011111111111111
100S00010000001
10000000000001
10010011111111
10010001
1000000111111
1000100000001
1000100000001
10001111111111
10001
10001
10001
11111