R 5000 900
NO ./texture/graywall.xpm
SO ./texture/greenwall.xpm
WE ./texture/woodwall.xpm
EA ./texture/redwall.xpm
S ./texture/light.xpm
F 25,25,25
C 100,100,100 

11111111
10000001
10000001
11121001
1020S001
10000001
10000001
10002001
10000001
10000001
10200001
10000001
10020001
11111111