R 2000 2000
NO ./texture/graywall.xpm
SO ./texture/woodwall.xpm
EA ./texture/redwall.xpm
WE ./texture/greenwall.xpm
S ./texture/light.xpm

C 25,20,25
F 120,120,90

   

                                                        111111
                                                        1020011111111
                11111111111111111                       11000000000001
                100000000000000011111111111111111111111111000000000001
                100000000000000000000000000000000000000000000000000001
                100000000000000011111111111111111001111111111111011111
                10000002002000001               1001           101
                10000000000000001               1001           101111111111111111
                10000000000000001               1001           100000000000000001
                10000002002000001           111110011111       111111111111111101
                10000000000000001           100000000001                      101
                10000002002000001           102000000201                      101
                10000000000000000111111111111000000000011111111111111111111111101
                10000000000000000000000000000000000000000000000000000000000000001
                11111011111111111111111111111000100000011111111111111111111111101
                    101                     102000000201                      101
                11111011111111111           100000000001                      101
                10000000000000001           111110011111                      101
                10000000000000001               1001                          101
                10000000000000001111111111111111100111111111111111111111111111101
                10000000000000000000000000000000000000000000000000000000000000001
                10000000000000001111111111111111111111111111111111111111111111111
                10000000000000001
                10000000020000001                1                                                   1111
                10000000000000001            1                                                       1001
                10000000000000001              1                                                     1111
                10000000000000001111111111111
                10000000000000000000000000001
                11111111111111111111111111001
                                         1001
                                         1000111111111
11111111111111111                        1000000200001
100000000000000011111111111111111111111111000000000001
100000000000000000000000000000000000000000000000000001
100000000000000011111111111111111001111111111111011111
10000000200020001               1001           101
10000000002000001               1001           101111111111111111
10000000200020001               1001           100000000000000001
10000000002000001           111110011111       111111111111111101
10000000200020001           100000000001                      101
10000000000000001           102000000201                      101
10000000000000001111111111111000000000011111111111111111111111101111111111111111111111111111111111111111111111111111111111111111111111111111111111111111111111111111111
10000000000N00000000000000000000000000000000000000000000000000000000000000000000000000000000000000000000000000000000000000000000000000000000000000000000000000000000001
11111011111111111111111111111000000000011111111111111111111111101111111111111111111111111111111111111111111111111111111111111111111111111111111111111111111111111111111
    101                     102000000201                      101
11111011111111111           100000000001                      101
10000000000000001           111110011111            1         101
10000000000000001               1001                          101
10000000000000001111111111111111100111111111111111111111111111101
10000000000000000000000000000000000000000000000000000000000000001
10000000000000001111111111111111111111111111111111111111111111111
10000000020002001
10000000000200001                               1
10000000020002001                                                                           1
10000000000200001
10000000020002001                           1
10000000000000001
11111111111111111
111111                                                          1
1111                            1
111
111 1