R 192 1080
NO ./path_to_the_north_texture
SO ./path_to_the_south_texture
WE ./path_to_the_west_texture
EA ./path_to_the_east_texture
S ./path_to_the_sprite_texture
F 254,100,0
C 225,30,69





1111111111   111111111111111
1000000001   000000000001111
1011000001111100002000001
1001000000000000000000001
111111111011000001110000111111
100000000011000000010111111111111
11110111111111011100000000001
11110111111111011101010000001
11000000000000011100000010001
10002001111000000110000001001
10000001  1000000011010101101
110000011110000111011110N1111
1000000000000001 101111010001
1111111111111111 111111111111