R      800       600

NO ./.assets/Stone.bmp
SO      ./.assets/Stone.bmp
EA  ./.assets/Stone.bmp
WE     ./.assets/Stone.bmp
   
S           ./.assets/Pepper.bmp


F      80,70,64 
C           100,110,128 

  11 1111 111 1111      1 1 11   1
 1001000110111000011111101    1
1111111100000000000000000111   1
    1000000000E000000011111111
  110000000000000000011111
    11110100001110101011101 1 1111
  111111011101111110111110111111 1
 11   111  11 11   1   111    111

