R 1920 1080 

NO ./.assets/Stone.bmp
SO ./.assets/Stone.bmp
EA ./.assets/Stone.bmp
WE ./.assets/Stone.bmp

S  ./.assets/Pepper.bmp


F 80,70,64 
C 100,110,128 
11111111111111111111111111111
12222222222222222222222222221
12222222222222222222222222221
12222222222222222222222222221
12222222222222222222222222221
12222222222222222222222222221
12222222222222222222222222221
12222222222222222222222222221
12222222222222222222222222221
12222222222222222222222222221
12222222222222222222222222221
12222222222222222222222222221
1N222222222222222222222222221
11111111111111111111111111111
