R 800 600

NO ./.assets/Stone.bmp
SO ./.assets/Stone.bmp
EA ./.assets/Stone.bmp
WE ./.assets/Stone.bmp

S  ./.assets/Pepper.bmp


F 80,70,64 
C 100,110,128 

11111
10001
10N01
10001
11111
11X11