R 5000 900
NO ./texture/graywall.xpm
SO ./texture/greenwall.xpm
WE ./texture/woodwall.xpm






EA ./texture/redwall.xpm
S ./texture/light.xpm
F 25,25,32




C 100,100,100

11111
1N001
10001
11111