R 5000 900
NO ./texture/graywall.xpm
SO ./texture/greenwall.xpm
WE ./texture/woodwall.xpm






EA ./texture/redwall.xpm
S ./texture/pillar.xpm
F 25,25,32

C 100,100,100


1111111111111111111111111111111111111111111111
1111111111111111111111111111111111111000000121
1111111111111111111111111111111111111000000101
1111111111111111111111111111111111111000000101
1111111111111111111111111111111111111000000101
1111111111111111111111111111111111111000000101
1111111111111111111111111111111111111000000101
1111111111111111111111111111111111111000000101
1111111111111111111111111111111111111000000101
1111111111111111111111111111111111111000000101
1111111111111111111111111111111111111000000101
1111111111111111111111111111111111111000000101
1111111111111111111111111111111111111000000101
1111111111111111111111111111111111111000000101
1111111111111111111111111111111111111200000101
1111111111111111111111111111111111111000000101
1111111111111111111111111111111111111000000101
1111111111111111111111111111111111111000000101
1111111111111111111111111111111111111000000101
1111111111111111111111111111111111111000000101
1111111111111111111111111111111111111000000121
1111111111111111111111111111111111111000000101
1111111111111111111111111111111111111001210001
1111111111111111111111111111111111111000000101
1111111111111111111111111111111111111111111101
10000000000000000000000000000200000000000000N1
1111111111111111111111111111111111111111111111